finish F IH N IH SH
end EH N D
THE	DH AH
OF	AH V
AND	AH N D
TO	T UW
A	AH
IN	IH N
FOR	F AO R
IS	IH Z
ON	AA N
THAT	DH AE T
BY	B AY
THIS	DH IH S
WITH	W IH DH
I	AY
YOU	Y UW
IT	IH T
NOT	N AA T
OR	AO R
BE	B IY
ARE	AA R
FROM	F R AH M
AT	AE T
AS	AE Z
YOUR	Y AO R
ALL	AO L
HAVE	HH AE V
NEW	N UW
MORE	M AO R
AN	AE N
WAS	W AA Z
WE	W IY
WILL	W IH L
HOME	HH OW M
CAN	K AE N
US	AH S
ABOUT	AH B AW T
IF	IH F
PAGE	P EY JH
MY	M AY
HAS	HH AE Z
SEARCH	S ER CH
FREE	F R IY
BUT	B AH T
OUR	AW ER
ONE	W AH N
OTHER	AH DH ER
DO	D UW
NO	N OW
INFORMATION	IH N F AO R M EY SH AH N
TIME	T AY M
THEY	DH EY
SITE	S AY T
HE	HH IY
UP	AH P
MAY	M EY
WHAT	W AH T
WHICH	W IH CH
THEIR	DH EH R
NEWS	N UW Z
OUT	AW T
USE	Y UW S
ANY	EH N IY
THERE	DH EH R
SEE	S IY
ONLY	OW N L IY
SO	S OW
HIS	HH IH Z
WHEN	W EH N
CONTACT	K AA N T AE K T
HERE	HH IY R
BUSINESS	B IH Z N AH S
WHO	HH UW
WEB	W EH B
ALSO	AO L S OW
NOW	N AW
HELP	HH EH L P
GET	G EH T
PM	P IY EH M
VIEW	V Y UW
ONLINE	AO N L AY N
C	S IY
E	IY
FIRST	F ER S T
AM	AE M
BEEN	B IH N
WOULD	W UH D
HOW	HH AW
WERE	W ER
ME	M IY
S	EH S
SERVICES	S ER V AH S AH Z
SOME	S AH M
THESE	DH IY Z
CLICK	K L IH K
ITS	IH T S
LIKE	L AY K
SERVICE	S ER V AH S
X	EH K S
THAN	DH AE N
FIND	F AY N D
PRICE	P R AY S
DATE	D EY T
BACK	B AE K
TOP	T AA P
PEOPLE	P IY P AH L
HAD	HH AE D
LIST	L IH S T
NAME	N EY M
JUST	JH AH S T
OVER	OW V ER
STATE	S T EY T
YEAR	Y IH R
DAY	D EY
INTO	IH N T UW
EMAIL	IY M EY L
TWO	T UW
HEALTH	HH EH L TH
N	EH N
WORLD	W ER L D
RE	R EY
NEXT	N EH K S T
USED	Y UW Z D
GO	G OW
B	B IY
WORK	W ER K
LAST	L AE S T
MOST	M OW S T
PRODUCTS	P R AA D AH K T S
MUSIC	M Y UW Z IH K
BUY	B AY
DATA	D EY T AH
MAKE	M EY K
THEM	DH EH M
SHOULD	SH UH D
PRODUCT	P R AA D AH K T
SYSTEM	S IH S T AH M
POST	P OW S T
HER	HH ER
CITY	S IH T IY
T	T IY
ADD	AE D
POLICY	P AA L AH S IY
NUMBER	N AH M B ER
SUCH	S AH CH
PLEASE	P L IY Z
AVAILABLE	AH V EY L AH B AH L
COPYRIGHT	K AA P IY R AY T
SUPPORT	S AH P AO R T
MESSAGE	M EH S AH JH
AFTER	AE F T ER
BEST	B EH S T
SOFTWARE	S AO F T W EH R
THEN	DH EH N
JAN	JH AE N
GOOD	G UH D
VIDEO	V IH D IY OW
WELL	W EH L
D	D IY
WHERE	W EH R
INFO	IH N F OW
RIGHTS	R AY T S
PUBLIC	P AH B L IH K
BOOKS	B UH K S
HIGH	HH AY
SCHOOL	S K UW L
THROUGH	TH R UW
M	EH M
EACH	IY CH
LINKS	L IH NG K S
SHE	SH IY
REVIEW	R IY V Y UW
YEARS	Y IH R Z
ORDER	AO R D ER
VERY	V EH R IY
PRIVACY	P R AY V AH S IY
BOOK	B UH K
ITEMS	AY T AH M Z
COMPANY	K AH M P AH N IY
R	AA R
READ	R EH D
GROUP	G R UW P
SEX	S EH K S
NEED	N IY D
MANY	M EH N IY
USER	Y UW Z ER
SAID	S EH D
DE	D IY
DOES	D AH Z
SET	S EH T
UNDER	AH N D ER
GENERAL	JH EH N ER AH L
RESEARCH	R IY S ER CH
UNIVERSITY	Y UW N AH V ER S AH T IY
JANUARY	JH AE N Y UW EH R IY
MAIL	M EY L
FULL	F UH L
MAP	M AE P
REVIEWS	R IY V Y UW Z
PROGRAM	P R OW G R AE M
LIFE	L AY F
KNOW	N OW
GAMES	G EY M Z
WAY	W EY
DAYS	D EY Z
MANAGEMENT	M AE N AH JH M AH N T
P	P IY
PART	P AA R T
COULD	K UH D
GREAT	G R EY T
UNITED	Y UW N AY T AH D
HOTEL	HH OW T EH L
REAL	R IY L
F	EH F
ITEM	AY T AH M
INTERNATIONAL	IH N T ER N AE SH AH N AA L
CENTER	S EH N T ER
EBAY	IY B EY
MUST	M AH S T
STORE	S T AO R
TRAVEL	T R AE V AH L
COMMENTS	K AA M EH N T S
MADE	M EY D
DEVELOPMENT	D IH V EH L AH P M AH N T
REPORT	R IY P AO R T
OFF	AO F
MEMBER	M EH M B ER
DETAILS	D IH T EY L Z
LINE	L AY N
TERMS	T ER M Z
BEFORE	B IH F AO R
HOTELS	HH OW T EH L Z
DID	D IH D
SEND	S EH N D
RIGHT	R AY T
TYPE	T AY P
BECAUSE	B IH K AO Z
LOCAL	L OW K AH L
THOSE	DH OW Z
USING	Y UW Z IH NG
RESULTS	R IH Z AH L T S
OFFICE	AO F AH S
EDUCATION	EH JH AH K EY SH AH N
NATIONAL	N AE SH AH N AH L
CAR	K AA R
DESIGN	D IH Z AY N
TAKE	T EY K
POSTED	P OW S T IH D
INTERNET	IH N T ER N EH T
ADDRESS	AE D R EH S
COMMUNITY	K AH M Y UW N AH T IY
WITHIN	W IH DH IH N
STATES	S T EY T S
AREA	EH R IY AH
WANT	W AA N T
PHONE	F OW N
DVD	D IY V IY D IY
SHIPPING	SH IH P IH NG
RESERVED	R IH Z ER V D
SUBJECT	S AH B JH EH K T
BETWEEN	B IH T W IY N
FORUM	F AO R AH M
FAMILY	F AE M AH L IY
L	EH L
LONG	L AO NG
BASED	B EY S T
W	D AH B AH L Y UW
CODE	K OW D
SHOW	SH OW
O	OW
EVEN	IY V IH N
BLACK	B L AE K
CHECK	CH EH K
SPECIAL	S P EH SH AH L
PRICES	P R AY S AH Z
WEBSITE	W EH B S AY T
INDEX	IH N D EH K S
BEING	B IY IH NG
WOMEN	W IH M AH N
MUCH	M AH CH
SIGN	S AY N
FILE	F AY L
LINK	L IH NG K
OPEN	OW P AH N
TODAY	T AH D EY
TECHNOLOGY	T EH K N AA L AH JH IY
SOUTH	S AW TH
CASE	K EY S
PROJECT	P R AA JH EH K T
SAME	S EY M
PAGES	P EY JH AH Z
UK	AH K
VERSION	V ER ZH AH N
SECTION	S EH K SH AH N
OWN	OW N
FOUND	F AW N D
SPORTS	S P AO R T S
HOUSE	HH AW S
RELATED	R IH L EY T IH D
SECURITY	S IH K Y UH R AH T IY
BOTH	B OW TH
G	JH IY
COUNTY	K AW N T IY
AMERICAN	AH M EH R IH K AH N
PHOTO	F OW T OW
GAME	G EY M
MEMBERS	M EH M B ER Z
POWER	P AW ER
WHILE	W AY L
CARE	K EH R
NETWORK	N EH T W ER K
DOWN	D AW N
COMPUTER	K AH M P Y UW T ER
SYSTEMS	S IH S T AH M Z
THREE	TH R IY
TOTAL	T OW T AH L
PLACE	P L EY S
END	EH N D
FOLLOWING	F AA L OW IH NG
DOWNLOAD	D AW N L OW D
H	EY CH
HIM	HH IH M
WITHOUT	W IH TH AW T
PER	P ER
ACCESS	AE K S EH S
THINK	TH IH NG K
NORTH	N AO R TH
RESOURCES	R IY S AO R S IH Z
CURRENT	K ER AH N T
POSTS	P OW S T S
BIG	B IH G
MEDIA	M IY D IY AH
LAW	L AO
CONTROL	K AH N T R OW L
WATER	W AO T ER
HISTORY	HH IH S T ER IY
PICTURES	P IH K CH ER Z
SIZE	S AY Z
ART	AA R T
PERSONAL	P ER S IH N AH L
SINCE	S IH N S
INCLUDING	IH N K L UW D IH NG
GUIDE	G AY D
SHOP	SH AA P
DIRECTORY	D ER EH K T ER IY
BOARD	B AO R D
LOCATION	L OW K EY SH AH N
CHANGE	CH EY N JH
WHITE	W AY T
TEXT	T EH K S T
SMALL	S M AO L
RATING	R EY T IH NG
RATE	R EY T
GOVERNMENT	G AH V ER N M AH N T
CHILDREN	CH IH L D R AH N
DURING	D UH R IH NG
USA	Y UW EH S EY
RETURN	R IH T ER N
STUDENTS	S T UW D AH N T S
V	V IY
SHOPPING	SH AA P IH NG
ACCOUNT	AH K AW N T
TIMES	T AY M Z
SITES	S AY T S
LEVEL	L EH V AH L
DIGITAL	D IH JH AH T AH L
PROFILE	P R OW F AY L
PREVIOUS	P R IY V IY AH S
FORM	F AO R M
EVENTS	IH V EH N T S
LOVE	L AH V
OLD	OW L D
JOHN	JH AA N
MAIN	M EY N
CALL	K AO L
HOURS	AW ER Z
IMAGE	IH M AH JH
DEPARTMENT	D IH P AA R T M AH N T
TITLE	T AY T AH L
DESCRIPTION	D IH S K R IH P SH AH N
NON	N AA N
K	K EY
Y	W AY
INSURANCE	IH N SH UH R AH N S
ANOTHER	AH N AH DH ER
WHY	W AY
SHALL	SH AE L
PROPERTY	P R AA P ER T IY
CLASS	K L AE S
CD	S IY D IY
STILL	S T IH L
MONEY	M AH N IY
QUALITY	K W AA L AH T IY
EVERY	EH V ER IY
LISTING	L IH S T IH NG
CONTENT	K AA N T EH N T
COUNTRY	K AH N T R IY
PRIVATE	P R AY V AH T
LITTLE	L IH T AH L
VISIT	V IH Z IH T
SAVE	S EY V
TOOLS	T UW L Z
LOW	L OW
REPLY	R IH P L AY
CUSTOMER	K AH S T AH M ER
DECEMBER	D IH S EH M B ER
COMPARE	K AH M P EH R
MOVIES	M UW V IY Z
INCLUDE	IH N K L UW D
COLLEGE	K AA L IH JH
VALUE	V AE L Y UW
ARTICLE	AA R T AH K AH L
YORK	Y AO R K
MAN	M AE N
CARD	K AA R D
JOBS	JH AA B Z
PROVIDE	P R AH V AY D
J	JH EY
FOOD	F UW D
SOURCE	S AO R S
AUTHOR	AO TH ER
DIFFERENT	D IH F ER AH N T
PRESS	P R EH S
U	Y UW
LEARN	L ER N
SALE	S EY L
AROUND	ER AW N D
PRINT	P R IH N T
COURSE	K AO R S
JOB	JH AA B
CANADA	K AE N AH D AH
PROCESS	P R AA S EH S
TEEN	T IY N
ROOM	R UW M
STOCK	S T AA K
TRAINING	T R EY N IH NG
TOO	T UW
CREDIT	K R EH D AH T
POINT	P OY N T
JOIN	JH OY N
SCIENCE	S AY AH N S
MEN	M EH N
CATEGORIES	K AE T AH G AO R IY Z
ADVANCED	AH D V AE N S T
WEST	W EH S T
SALES	S EY L Z
LOOK	L UH K
ENGLISH	IH NG G L IH SH
LEFT	L EH F T
TEAM	T IY M
ESTATE	EH S T EY T
BOX	B AA K S
CONDITIONS	K AH N D IH SH AH N Z
SELECT	S AH L EH K T
WINDOWS	W IH N D OW Z
PHOTOS	F OW T OW Z
GAY	G EY
THREAD	TH R EH D
WEEK	W IY K
CATEGORY	K AE T AH G AO R IY
NOTE	N OW T
LIVE	L AY V
LARGE	L AA R JH
GALLERY	G AE L ER IY
TABLE	T EY B AH L
REGISTER	R EH JH IH S T ER
HOWEVER	HH AW EH V ER
JUNE	JH UW N
OCTOBER	AA K T OW B ER
NOVEMBER	N OW V EH M B ER
MARKET	M AA R K AH T
LIBRARY	L AY B R EH R IY
REALLY	R IH L IY
ACTION	AE K SH AH N
START	S T AA R T
SERIES	S IH R IY Z
MODEL	M AA D AH L
FEATURES	F IY CH ER Z
AIR	EH R
INDUSTRY	IH N D AH S T R IY
PLAN	P L AE N
HUMAN	HH Y UW M AH N
PROVIDED	P R AH V AY D AH D
TV	T IY V IY
YES	Y EH S
REQUIRED	R IY K W AY ER D
SECOND	S EH K AH N D
HOT	HH AA T
ACCESSORIES	AE K S EH S ER IY Z
COST	K AA S T
MOVIE	M UW V IY
FORUMS	F AO R AH M Z
MARCH	M AA R CH
LA	L AA
SEPTEMBER	S EH P T EH M B ER
BETTER	B EH T ER
SAY	S EY
QUESTIONS	K W EH S CH AH N Z
JULY	JH UW L AY
YAHOO	Y AA HH UW
GOING	G OW IH NG
MEDICAL	M EH D AH K AH L
TEST	T EH S T
FRIEND	F R EH N D
COME	K AH M
DEC	D EH K
SERVER	S ER V ER
PC	P IY S IY
STUDY	S T AH D IY
APPLICATION	AE P L AH K EY SH AH N
CART	K AA R T
STAFF	S T AE F
ARTICLES	AA R T AH K AH L Z
SAN	S AE N
FEEDBACK	F IY D B AE K
AGAIN	AH G EH N
PLAY	P L EY
LOOKING	L UH K IH NG
ISSUES	IH SH UW Z
APRIL	EY P R AH L
NEVER	N EH V ER
USERS	Y UW Z ER Z
COMPLETE	K AH M P L IY T
STREET	S T R IY T
TOPIC	T AA P IH K
COMMENT	K AA M EH N T
FINANCIAL	F AH N AE N SH AH L
THINGS	TH IH NG Z
WORKING	W ER K IH NG
AGAINST	AH G EH N S T
STANDARD	S T AE N D ER D
TAX	T AE K S
PERSON	P ER S AH N
BELOW	B IH L OW
MOBILE	M OW B AH L
LESS	L EH S
GOT	G AA T
BLOG	B L AO G
PARTY	P AA R T IY
PAYMENT	P EY M AH N T
EQUIPMENT	IH K W IH P M AH N T
LOGIN	L AA G IH N
STUDENT	S T UW D AH N T
LET	L EH T
PROGRAMS	P R OW G R AE M Z
OFFERS	AO F ER Z
LEGAL	L IY G AH L
ABOVE	AH B AH V
RECENT	R IY S AH N T
PARK	P AA R K
STORES	S T AO R Z
SIDE	S AY D
ACT	AE K T
PROBLEM	P R AA B L AH M
RED	R EH D
GIVE	G IH V
MEMORY	M EH M ER IY
PERFORMANCE	P ER F AO R M AH N S
SOCIAL	S OW SH AH L
Q	K Y UW
AUGUST	AA G AH S T
QUOTE	K W OW T
LANGUAGE	L AE NG G W AH JH
STORY	S T AO R IY
SELL	S EH L
OPTIONS	AA P SH AH N Z
EXPERIENCE	IH K S P IH R IY AH N S
RATES	R EY T S
CREATE	K R IY EY T
KEY	K IY
BODY	B AA D IY
YOUNG	Y AH NG
AMERICA	AH M EH R IH K AH
IMPORTANT	IH M P AO R T AH N T
FIELD	F IY L D
FEW	F Y UW
EAST	IY S T
PAPER	P EY P ER
SINGLE	S IH NG G AH L
II	IY
AGE	EY JH
ACTIVITIES	AE K T IH V IH T IY Z
CLUB	K L AH B
EXAMPLE	IH G Z AE M P AH L
GIRLS	G ER L Z
ADDITIONAL	AH D IH SH AH N AH L
PASSWORD	P AE S W ER D
Z	Z IY
LATEST	L EY T AH S T
SOMETHING	S AH M TH IH NG
ROAD	R OW D
GIFT	G IH F T
QUESTION	K W EH S CH AH N
CHANGES	CH EY N JH AH Z
NIGHT	N AY T
CA	K AH
HARD	HH AA R D
TEXAS	T EH K S AH S
OCT	AO K T
PAY	P EY
FOUR	F AO R
POKER	P OW K ER
STATUS	S T AE T AH S
BROWSE	B R AW Z
ISSUE	IH SH UW
RANGE	R EY N JH
BUILDING	B IH L D IH NG
SELLER	S EH L ER
COURT	K AO R T
FEBRUARY	F EH B Y AH W EH R IY
ALWAYS	AO L W EY Z
RESULT	R IH Z AH L T
AUDIO	AA D IY OW
LIGHT	L AY T
WRITE	R AY T
WAR	W AO R
NOV	N OW V
OFFER	AO F ER
BLUE	B L UW
GROUPS	G R UW P S
AL	AE L
EASY	IY Z IY
GIVEN	G IH V AH N
FILES	F AY L Z
EVENT	IH V EH N T
RELEASE	R IY L IY S
ANALYSIS	AE N AE L IH S IH S
REQUEST	R IH K W EH S T
FAX	F AE K S
CHINA	CH AY N AH
MAKING	M EY K IH NG
PICTURE	P IH K CH ER
NEEDS	N IY D Z
POSSIBLE	P AA S AH B AH L
MIGHT	M AY T
PROFESSIONAL	P R AH F EH SH AH N AH L
YET	Y EH T
MONTH	M AH N TH
MAJOR	M EY JH ER
STAR	S T AA R
AREAS	EH R IY AH Z
FUTURE	F Y UW CH ER
SPACE	S P EY S
COMMITTEE	K AH M IH T IY
HAND	HH AE N D
SUN	S AH N
CARDS	K AA R D Z
PROBLEMS	P R AA B L AH M Z
LONDON	L AH N D AH N
WASHINGTON	W AA SH IH NG T AH N
MEETING	M IY T IH NG
RSS	AA R EH S
BECOME	B IH K AH M
INTEREST	IH N T AH R EH S T
ID	IH D
CHILD	CH AY L D
KEEP	K IY P
ENTER	EH N T ER
CALIFORNIA	K AE L AH F AO R N Y AH
PORN	P AO R N
SHARE	SH EH R
SIMILAR	S IH M AH L ER
GARDEN	G AA R D AH N
SCHOOLS	S K UW L Z
MILLION	M IH L Y AH N
ADDED	AE D IH D
REFERENCE	R EH F ER AH N S
COMPANIES	K AH M P AH N IY Z
LISTED	L IH S T AH D
BABY	B EY B IY
LEARNING	L ER N IH NG
ENERGY	EH N ER JH IY
RUN	R AH N
DELIVERY	D IH L IH V ER IY
NET	N EH T
POPULAR	P AA P Y AH L ER
TERM	T ER M
FILM	F IH L M
STORIES	S T AO R IY Z
PUT	P UH T
COMPUTERS	K AH M P Y UW T ER Z
JOURNAL	JH ER N AH L
REPORTS	R IH P AO R T S
CO	K OW
TRY	T R AY
WELCOME	W EH L K AH M
CENTRAL	S EH N T R AH L
IMAGES	IH M AH JH AH Z
PRESIDENT	P R EH Z IH D AH N T
NOTICE	N OW T AH S
GOD	G AA D
ORIGINAL	ER IH JH AH N AH L
HEAD	HH EH D
RADIO	R EY D IY OW
UNTIL	AH N T IH L
CELL	S EH L
COLOR	K AH L ER
SELF	S EH L F
COUNCIL	K AW N S AH L
AWAY	AH W EY
INCLUDES	IH N K L UW D Z
TRACK	T R AE K
AUSTRALIA	AO S T R EY L Y AH
DISCUSSION	D IH S K AH SH AH N
ARCHIVE	AA R K AY V
ONCE	W AH N S
OTHERS	AH DH ER Z
ENTERTAINMENT	EH N T ER T EY N M AH N T
AGREEMENT	AH G R IY M AH N T
FORMAT	F AO R M AE T
LEAST	L IY S T
SOCIETY	S OW S AY IH T IY
MONTHS	M AH N TH S
LOG	L AO G
SAFETY	S EY F T IY
FRIENDS	F R EH N D Z
SURE	SH UH R
FAQ	F AE K
TRADE	T R EY D
EDITION	AH D IH SH AH N
CARS	K AA R Z
MESSAGES	M EH S AH JH AH Z
MARKETING	M AA R K AH T IH NG
TELL	T EH L
FURTHER	F ER DH ER
UPDATED	AH P D EY T AH D
ASSOCIATION	AH S OW S IY EY SH AH N
ABLE	EY B AH L
HAVING	HH AE V IH NG
PROVIDES	P R AH V AY D Z
DAVID	D EY V IH D
FUN	F AH N
ALREADY	AO L R EH D IY
GREEN	G R IY N
STUDIES	S T AH D IY Z
CLOSE	K L OW S
COMMON	K AA M AH N
DRIVE	D R AY V
SPECIFIC	S P AH S IH F IH K
SEVERAL	S EH V ER AH L
GOLD	G OW L D
FEB	F EH B Y AH W EH R IY
LIVING	L IH V IH NG
SEP	S EH P
COLLECTION	K AH L EH K SH AH N
CALLED	K AO L D
SHORT	SH AO R T
ARTS	AA R T S
LOT	L AA T
ASK	AE S K
DISPLAY	D IH S P L EY
LIMITED	L IH M AH T AH D
POWERED	P AW ER D
SOLUTIONS	S AH L UW SH AH N Z
MEANS	M IY N Z
DIRECTOR	D ER EH K T ER
DAILY	D EY L IY
BEACH	B IY CH
PAST	P AE S T
NATURAL	N AE CH ER AH L
WHETHER	W EH DH ER
DUE	D UW
ET	EH T
ELECTRONICS	IH L EH K T R AA N IH K S
FIVE	F AY V
UPON	AH P AA N
PERIOD	P IH R IY AH D
PLANNING	P L AE N IH NG
DATABASE	D EY T AH B EY S
SAYS	S EH Z
OFFICIAL	AH F IH SH AH L
WEATHER	W EH DH ER
MAR	M AA R
LAND	L AE N D
AVERAGE	AE V ER IH JH
DONE	D AH N
TECHNICAL	T EH K N IH K AH L
WINDOW	W IH N D OW
FRANCE	F R AE N S
PRO	P R OW
REGION	R IY JH AH N
ISLAND	AY L AH N D
RECORD	R AH K AO R D
DIRECT	D ER EH K T
MICROSOFT	M AY K R OW S AO F T
CONFERENCE	K AA N F ER AH N S
ENVIRONMENT	IH N V AY R AH N M AH N T
RECORDS	R AH K AO R D Z
ST	EH S T
DISTRICT	D IH S T R IH K T
CALENDAR	K AE L AH N D ER
COSTS	K AA S T S
STYLE	S T AY L
URL	AH R L
FRONT	F R AH N T
STATEMENT	S T EY T M AH N T
UPDATE	AH P D EY T
PARTS	P AA R T S
AUG	AO G AH S T
EVER	EH V ER
DOWNLOADS	D AW N L OW D Z
EARLY	ER L IY
MILES	M AY L Z
SOUND	S AW N D
RESOURCE	R IY S AO R S
PRESENT	P R EH Z AH N T
APPLICATIONS	AE P L AH K EY SH AH N Z
EITHER	IY DH ER
AGO	AH G OW
DOCUMENT	D AA K Y AH M EH N T
WORD	W ER D
WORKS	W ER K S
MATERIAL	M AH T IH R IY AH L
BILL	B IH L
APR	AE P R
WRITTEN	R IH T AH N
TALK	T AO K
FEDERAL	F EH D ER AH L
HOSTING	HH OW S T IH NG
RULES	R UW L Z
FINAL	F AY N AH L
ADULT	AH D AH L T
TICKETS	T IH K AH T S
THING	TH IH NG
CENTRE	S EH N T ER
REQUIREMENTS	R IH K W AY R M AH N T S
VIA	V AY AH
CHEAP	CH IY P
NUDE	N UW D
KIDS	K IH D Z
FINANCE	F AH N AE N S
TRUE	T R UW
MINUTES	M IH N AH T S
ELSE	EH L S
MARK	M AA R K
THIRD	TH ER D
ROCK	R AA K
GIFTS	G IH F T S
EUROPE	Y UH R AH P
READING	R IY D IH NG
TOPICS	T AA P IH K S
BAD	B AE D
INDIVIDUAL	IH N D AH V IH JH AH W AH L
TIPS	T IH P S
PLUS	P L AH S
AUTO	AO T OW
COVER	K AH V ER
USUALLY	Y UW ZH AH W AH L IY
EDIT	EH D AH T
TOGETHER	T AH G EH DH ER
VIDEOS	V IH D IY OW Z
PERCENT	P ER S EH N T
FAST	F AE S T
FUNCTION	F AH NG K SH AH N
FACT	F AE K T
UNIT	Y UW N AH T
GETTING	G EH T IH NG
GLOBAL	G L OW B AH L
TECH	T EH K
MEET	M IY T
FAR	F AA R
ECONOMIC	EH K AH N AA M IH K
EN	EH N
PLAYER	P L EY ER
PROJECTS	P R AA JH EH K T S
LYRICS	L IH R IH K S
OFTEN	AO F T AH N
SUBSCRIBE	S AH B S K R AY B
SUBMIT	S AH B M IH T
GERMANY	JH ER M AH N IY
AMOUNT	AH M AW N T
WATCH	W AA CH
INCLUDED	IH N K L UW D AH D
FEEL	F IY L
THOUGH	DH OW
BANK	B AE NG K
RISK	R IH S K
THANKS	TH AE NG K S
EVERYTHING	EH V R IY TH IH NG
DEALS	D IY L Z
VARIOUS	V EH R IY AH S
WORDS	W ER D Z
LINUX	L IH N AH K S
JUL	JH AH L
PRODUCTION	P R AH D AH K SH AH N
COMMERCIAL	K AH M ER SH AH L
JAMES	JH EY M Z
WEIGHT	W EY T
TOWN	T AW N
HEART	HH AA R T
ADVERTISING	AE D V ER T AY Z IH NG
RECEIVED	R AH S IY V D
CHOOSE	CH UW Z
TREATMENT	T R IY T M AH N T
NEWSLETTER	N UW Z L EH T ER
ARCHIVES	AA R K AY V Z
POINTS	P OY N T S
KNOWLEDGE	N AA L AH JH
MAGAZINE	M AE G AH Z IY N
ERROR	EH R ER
CAMERA	K AE M ER AH
JUN	JH AH N
GIRL	G ER L
CURRENTLY	K ER AH N T L IY
CONSTRUCTION	K AH N S T R AH K SH AH N
TOYS	T OY Z
REGISTERED	R EH JH IH S T ER D
CLEAR	K L IH R
GOLF	G AA L F
RECEIVE	R AH S IY V
DOMAIN	D OW M EY N
METHODS	M EH TH AH D Z
CHAPTER	CH AE P T ER
MAKES	M EY K S
PROTECTION	P R AH T EH K SH AH N
POLICIES	P AA L AH S IY Z
LOAN	L OW N
WIDE	W AY D
BEAUTY	B Y UW T IY
MANAGER	M AE N AH JH ER
INDIA	IH N D IY AH
POSITION	P AH Z IH SH AH N
TAKEN	T EY K AH N
SORT	S AO R T
LISTINGS	L IH S T IH NG Z
MODELS	M AA D AH L Z
MICHAEL	M AY K AH L
KNOWN	N OW N
HALF	HH AE F
CASES	K EY S AH Z
STEP	S T EH P
ENGINEERING	EH N JH AH N IH R IH NG
FLORIDA	F L AO R AH D AH
SIMPLE	S IH M P AH L
QUICK	K W IH K
NONE	N AH N
WIRELESS	W AY R L IH S
LICENSE	L AY S AH N S
PAUL	P AO L
FRIDAY	F R AY D IY
LAKE	L EY K
WHOLE	HH OW L
ANNUAL	AE N Y UW AH L
PUBLISHED	P AH B L IH SH T
LATER	L EY T ER
BASIC	B EY S IH K
SONY	S OW N IY
SHOWS	SH OW Z
CORPORATE	K AO R P ER AH T
GOOGLE	G UW G AH L
CHURCH	CH ER CH
METHOD	M EH TH AH D
PURCHASE	P ER CH AH S
CUSTOMERS	K AH S T AH M ER Z
ACTIVE	AE K T IH V
RESPONSE	R IH S P AA N S
PRACTICE	P R AE K T IH S
HARDWARE	HH AA R D W EH R
FIGURE	F IH G Y ER
MATERIALS	M AH T IH R IY AH L Z
FIRE	F AY ER
HOLIDAY	HH AA L AH D EY
CHAT	CH AE T
ENOUGH	IH N AH F
DESIGNED	D IH Z AY N D
ALONG	AH L AO NG
AMONG	AH M AH NG
DEATH	D EH TH
WRITING	R AY T IH NG
SPEED	S P IY D
HTML	EY CH T IY EH M L
COUNTRIES	K AH N T R IY Z
LOSS	L AO S
FACE	F EY S
BRAND	B R AE N D
DISCOUNT	D IH S K AW N T
HIGHER	HH AY ER
EFFECTS	IH F EH K T S
CREATED	K R IY EY T AH D
REMEMBER	R IH M EH M B ER
STANDARDS	S T AE N D ER D Z
OIL	OY L
BIT	B IH T
YELLOW	Y EH L OW
POLITICAL	P AH L IH T AH K AH L
INCREASE	IH N K R IY S
ADVERTISE	AE D V ER T AY Z
KINGDOM	K IH NG D AH M
BASE	B EY S
NEAR	N IH R
ENVIRONMENTAL	IH N V AY R AH N M EH N T AH L
THOUGHT	TH AO T
STUFF	S T AH F
FRENCH	F R EH N CH
STORAGE	S T AO R AH JH
OH	OW
JAPAN	JH AH P AE N
DOING	D UW IH NG
LOANS	L OW N Z
SHOES	SH UW Z
ENTRY	EH N T R IY
STAY	S T EY
NATURE	N EY CH ER
ORDERS	AO R D ER Z
AVAILABILITY	AH V EY L AH B IH L AH T IY
AFRICA	AE F R IH K AA
SUMMARY	S AH M ER IY
TURN	T ER N
MEAN	M IY N
GROWTH	G R OW TH
NOTES	N OW T S
AGENCY	EY JH AH N S IY
KING	K IH NG
MONDAY	M AH N D IY
EUROPEAN	Y UH R AH P IY AH N
ACTIVITY	AE K T IH V IH T IY
COPY	K AA P IY
ALTHOUGH	AO L DH OW
DRUG	D R AH G
PICS	P IH K S
WESTERN	W EH S T ER N
INCOME	IH N K AH M
FORCE	F AO R S
CASH	K AE SH
EMPLOYMENT	EH M P L OY M AH N T
OVERALL	OW V ER AO L
BAY	B EY
RIVER	R IH V ER
COMMISSION	K AH M IH SH AH N
AD	AE D
PACKAGE	P AE K AH JH
CONTENTS	K AA N T EH N T S
SEEN	S IY N
PLAYERS	P L EY ER Z
ENGINE	EH N JH AH N
PORT	P AO R T
ALBUM	AE L B AH M
REGIONAL	R IY JH AH N AH L
STOP	S T AA P
SUPPLIES	S AH P L AY Z
STARTED	S T AA R T AH D
ADMINISTRATION	AE D M IH N IH S T R EY SH AH N
BAR	B AA R
INSTITUTE	IH N S T IH T UW T
VIEWS	V Y UW Z
PLANS	P L AE N Z
DOUBLE	D AH B AH L
DOG	D AO G
BUILD	B IH L D
SCREEN	S K R IY N
EXCHANGE	IH K S CH EY N JH
TYPES	T AY P S
SOON	S UW N
SPONSORED	S P AA N S ER D
LINES	L AY N Z
ELECTRONIC	IH L EH K T R AA N IH K
CONTINUE	K AH N T IH N Y UW
ACROSS	AH K R AO S
BENEFITS	B EH N AH F IH T S
NEEDED	N IY D AH D
SEASON	S IY Z AH N
APPLY	AH P L AY
SOMEONE	S AH M W AH N
HELD	HH EH L D
NY	N AY
ANYTHING	EH N IY TH IH NG
PRINTER	P R IH N T ER
CONDITION	K AH N D IH SH AH N
EFFECTIVE	IH F EH K T IH V
BELIEVE	B IH L IY V
ORGANIZATION	AO R G AH N AH Z EY SH AH N
EFFECT	IH F EH K T
ASKED	AE S K T
EUR	AH R
MIND	M AY N D
SUNDAY	S AH N D EY
SELECTION	S AH L EH K SH AH N
CASINO	K AH S IY N OW
PDF	P IY D IY F
LOST	L AO S T
TOUR	T UH R
MENU	M EH N Y UW
VOLUME	V AA L Y UW M
CROSS	K R AO S
ANYONE	EH N IY W AH N
MORTGAGE	M AO R G AH JH
HOPE	HH OW P
SILVER	S IH L V ER
CORPORATION	K AO R P ER EY SH AH N
WISH	W IH SH
INSIDE	IH N S AY D
SOLUTION	S AH L UW SH AH N
MATURE	M AH CH UH R
ROLE	R OW L
RATHER	R AE DH ER
WEEKS	W IY K S
ADDITION	AH D IH SH AH N
CAME	K EY M
SUPPLY	S AH P L AY
NOTHING	N AH TH IH NG
CERTAIN	S ER T AH N
USR	AH Z R
EXECUTIVE	IH G Z EH K Y AH T IH V
RUNNING	R AH N IH NG
LOWER	L OW ER
NECESSARY	N EH S AH S EH R IY
UNION	Y UW N Y AH N
JEWELRY	JH UW AH L R IY
ACCORDING	AH K AO R D IH NG
DC	D IY S IY
CLOTHING	K L OW DH IH NG
MON	M OW N
COM	K AA M
PARTICULAR	P ER T IH K Y AH L ER
FINE	F AY N
NAMES	N EY M Z
ROBERT	R AA B ER T
HOMEPAGE	HH OW M P EY JH
HOUR	AW ER
GAS	G AE S
SKILLS	S K IH L Z
SIX	S IH K S
BUSH	B UH SH
ISLANDS	AY L AH N D Z
ADVICE	AE D V AY S
CAREER	K ER IH R
MILITARY	M IH L AH T EH R IY
RENTAL	R EH N T AH L
DECISION	D IH S IH ZH AH N
LEAVE	L IY V
BRITISH	B R IH T IH SH
TEENS	T IY N Z
PRE	P R IY
HUGE	HH Y UW JH
SAT	S AE T
WOMAN	W UH M AH N
FACILITIES	F AH S IH L AH T IY Z
ZIP	Z IH P
BID	B IH D
KIND	K AY N D
SELLERS	S EH L ER Z
MIDDLE	M IH D AH L
MOVE	M UW V
CABLE	K EY B AH L
OPPORTUNITIES	AA P ER T UW N AH T IY Z
TAKING	T EY K IH NG
VALUES	V AE L Y UW Z
DIVISION	D IH V IH ZH AH N
COMING	K AH M IH NG
TUESDAY	T UW Z D IY
OBJECT	AA B JH EH K T
LESBIAN	L EH Z B IY AH N
APPROPRIATE	AH P R OW P R IY AH T
MACHINE	M AH SH IY N
LOGO	L OW G OW
LENGTH	L EH NG K TH
ACTUALLY	AE K CH UW AH L IY
NICE	N AY S
SCORE	S K AO R
STATISTICS	S T AH T IH S T IH K S
CLIENT	K L AY AH N T
OK	OW K EY
RETURNS	R IH T ER N Z
CAPITAL	K AE P IH T AH L
FOLLOW	F AA L OW
SAMPLE	S AE M P AH L
INVESTMENT	IH N V EH S T M AH N T
SENT	S EH N T
SHOWN	SH OW N
SATURDAY	S AE T ER D IY
CHRISTMAS	K R IH S M AH S
ENGLAND	IH NG G L AH N D
CULTURE	K AH L CH ER
BAND	B AE N D
FLASH	F L AE SH
MS	M IH Z
LEAD	L EH D
GEORGE	JH AO R JH
CHOICE	CH OY S
WENT	W EH N T
STARTING	S T AA R T IH NG
REGISTRATION	R EH JH IH S T R EY SH AH N
FRI	F R IY
THURSDAY	TH ER Z D EY
COURSES	K AO R S AH Z
CONSUMER	K AH N S UW M ER
HI	HH AY
AIRPORT	EH R P AO R T
FOREIGN	F AO R AH N
ARTIST	AA R T AH S T
OUTSIDE	AW T S AY D
FURNITURE	F ER N IH CH ER
LEVELS	L EH V AH L Z
CHANNEL	CH AE N AH L
LETTER	L EH T ER
MODE	M OW D
PHONES	F OW N Z
IDEAS	AY D IY AH Z
WEDNESDAY	W EH N Z D IY
STRUCTURE	S T R AH K CH ER
FUND	F AH N D
SUMMER	S AH M ER
ALLOW	AH L AW
DEGREE	D IH G R IY
CONTRACT	K AA N T R AE K T
BUTTON	B AH T AH N
RELEASES	R IH L IY S IH Z
WED	W EH D
HOMES	HH OW M Z
SUPER	S UW P ER
MALE	M EY L
MATTER	M AE T ER
CUSTOM	K AH S T AH M
VIRGINIA	V ER JH IH N Y AH
ALMOST	AO L M OW S T
TOOK	T UH K
LOCATED	L OW K EY T AH D
MULTIPLE	M AH L T AH P AH L
ASIAN	EY ZH AH N
DISTRIBUTION	D IH S T R AH B Y UW SH AH N
EDITOR	EH D AH T ER
INN	IH N
INDUSTRIAL	IH N D AH S T R IY AH L
CAUSE	K AA Z
POTENTIAL	P AH T EH N SH AH L
SONG	S AO NG
CNET	K N EH T
LTD	L IH M IH T IH D
LOS	L OW S
HP	EY CH P
FOCUS	F OW K AH S
LATE	L EY T
FALL	F AO L
FEATURED	F IY CH ER D
IDEA	AY D IY AH
ROOMS	R UW M Z
FEMALE	F IY M EY L
RESPONSIBLE	R IY S P AA N S AH B AH L
INC	IH NG K
COMMUNICATIONS	K AH M Y UW N AH K EY SH AH N Z
WIN	W IH N
ASSOCIATED	AH S OW S IY EY T AH D
THOMAS	T AA M AH S
PRIMARY	P R AY M EH R IY
CANCER	K AE N S ER
NUMBERS	N AH M B ER Z
REASON	R IY Z AH N
TOOL	T UW L
BROWSER	B R AW Z ER
SPRING	S P R IH NG
FOUNDATION	F AW N D EY SH AH N
ANSWER	AE N S ER
VOICE	V OY S
EG	EH G
FRIENDLY	F R EH N D L IY
SCHEDULE	S K EH JH UH L
DOCUMENTS	D AA K Y AH M AH N T S
COMMUNICATION	K AH M Y UW N AH K EY SH AH N
PURPOSE	P ER P AH S
FEATURE	F IY CH ER
BED	B EH D
COMES	K AH M Z
POLICE	P AH L IY S
EVERYONE	EH V R IY W AH N
INDEPENDENT	IH N D IH P EH N D AH N T
IP	IH P
APPROACH	AH P R OW CH
CAMERAS	K AE M ER AH Z
BROWN	B R AW N
PHYSICAL	F IH Z IH K AH L
OPERATING	AA P ER EY T IH NG
HILL	HH IH L
MAPS	M AE P S
MEDICINE	M EH D AH S AH N
DEAL	D IY L
HOLD	HH OW L D
RATINGS	R EY T IH NG Z
CHICAGO	SH AH K AA G OW
FORMS	F AO R M Z
GLASS	G L AE S
HAPPY	HH AE P IY
TUE	T UW
SMITH	S M IH TH
WANTED	W AO N T IH D
DEVELOPED	D IH V EH L AH P T
THANK	TH AE NG K
SAFE	S EY F
UNIQUE	Y UW N IY K
SURVEY	S ER V EY
PRIOR	P R AY ER
TELEPHONE	T EH L AH F OW N
SPORT	S P AO R T
READY	R EH D IY
FEED	F IY D
ANIMAL	AE N AH M AH L
SOURCES	S AO R S AH Z
MEXICO	M EH K S AH K OW
POPULATION	P AA P Y AH L EY SH AH N
PA	P AA
REGULAR	R EH G Y AH L ER
SECURE	S IH K Y UH R
NAVIGATION	N AE V AH G EY SH AH N
OPERATIONS	AA P ER EY SH AH N Z
THEREFORE	DH EH R F AO R
ASS	AE S
SIMPLY	S IH M P L IY
EVIDENCE	EH V AH D AH N S
STATION	S T EY SH AH N
CHRISTIAN	K R IH S CH AH N
ROUND	R AW N D
PAYPAL	P EY P AE L
FAVORITE	F EY V ER IH T
UNDERSTAND	AH N D ER S T AE N D
OPTION	AA P SH AH N
MASTER	M AE S T ER
VALLEY	V AE L IY
RECENTLY	R IY S AH N T L IY
PROBABLY	P R AA B AH B L IY
THU	TH UW
RENTALS	R EH N T AH L Z
SEA	S IY
BUILT	B IH L T
PUBLICATIONS	P AH B L IH K EY SH AH N Z
BLOOD	B L AH D
CUT	K AH T
WORLDWIDE	W ER L D W AY D
IMPROVE	IH M P R UW V
CONNECTION	K AH N EH K SH AH N
PUBLISHER	P AH B L IH SH ER
HALL	HH AO L
LARGER	L AA R JH ER
ANTI	AE N T IY
NETWORKS	N EH T W ER K S
EARTH	ER TH
PARENTS	P EH R AH N T S
NOKIA	N OW K IY AH
IMPACT	IH M P AE K T
TRANSFER	T R AE N S F ER
INTRODUCTION	IH N T R AH D AH K SH AH N
KITCHEN	K IH CH AH N
STRONG	S T R AO NG
TEL	T EH L
CAROLINA	K EH R AH L AY N AH
WEDDING	W EH D IH NG
PROPERTIES	P R AA P ER T IY Z
HOSPITAL	HH AA S P IH T AH L
GROUND	G R AW N D
OVERVIEW	OW V ER V Y UW
SHIP	SH IH P
ACCOMMODATION	AH K AA M AH D EY SH AH N
OWNERS	OW N ER Z
DISEASE	D IH Z IY Z
TX	T IY Z
EXCELLENT	EH K S AH L AH N T
PAID	P EY D
ITALY	IH T AH L IY
PERFECT	P ER F EH K T
HAIR	HH EH R
OPPORTUNITY	AA P ER T UW N AH T IY
KIT	K IH T
CLASSIC	K L AE S IH K
BASIS	B EY S AH S
COMMAND	K AH M AE N D
CITIES	S IH T IY Z
WILLIAM	W IH L Y AH M
EXPRESS	IH K S P R EH S
ANAL	EY N AH L
AWARD	AH W AO R D
DISTANCE	D IH S T AH N S
TREE	T R IY
PETER	P IY T ER
ASSESSMENT	AH S EH S M AH N T
ENSURE	EH N SH UH R
THUS	DH AH S
WALL	W AO L
IE	AY
INVOLVED	IH N V AA L V D
EL	EH L
EXTRA	EH K S T R AH
ESPECIALLY	AH S P EH SH L IY
INTERFACE	IH N T ER F EY S
PUSSY	P UH S IY
PARTNERS	P AA R T N ER Z
BUDGET	B AH JH IH T
RATED	R EY T AH D
GUIDES	G AY D Z
SUCCESS	S AH K S EH S
MAXIMUM	M AE K S AH M AH M
MA	M AA
OPERATION	AA P ER EY SH AH N
EXISTING	IH G Z IH S T IH NG
QUITE	K W AY T
SELECTED	S AH L EH K T AH D
BOY	B OY
AMAZON	AE M AH Z AA N
PATIENTS	P EY SH AH N T S
RESTAURANTS	R EH S T ER AA N T S
BEAUTIFUL	B Y UW T AH F AH L
WARNING	W AO R N IH NG
WINE	W AY N
LOCATIONS	L OW K EY SH AH N Z
HORSE	HH AO R S
VOTE	V OW T
FORWARD	F AO R W ER D
FLOWERS	F L AW ER Z
STARS	S T AA R Z
SIGNIFICANT	S AH G N IH F IH K AH N T
LISTS	L IH S T S
TECHNOLOGIES	T EH K N AA L AH JH IY Z
OWNER	OW N ER
RETAIL	R IY T EY L
ANIMALS	AE N AH M AH L Z
USEFUL	Y UW S F AH L
DIRECTLY	D ER EH K T L IY
MANUFACTURER	M AE N Y AH F AE K CH ER ER
WAYS	W EY Z
EST	EH S T
SON	S AH N
PROVIDING	P R AH V AY D IH NG
RULE	R UW L
MAC	M AE K
HOUSING	HH AW Z IH NG
TAKES	T EY K S
III	IY IY
GMT	JH IY EH M T
BRING	B R IH NG
CATALOG	K AE T AH L AO G
SEARCHES	S ER CH IH Z
MAX	M AE K S
TRYING	T R AY IH NG
MOTHER	M AH DH ER
AUTHORITY	AH TH AO R AH T IY
CONSIDERED	K AH N S IH D ER D
TOLD	T OW L D
XML	EH K S EH M EH L
TRAFFIC	T R AE F IH K
PROGRAMME	P R OW G R AE M
JOINED	JH OY N D
INPUT	IH N P UH T
STRATEGY	S T R AE T AH JH IY
FEET	F IY T
AGENT	EY JH AH N T
VALID	V AE L IH D
BIN	B IH N
MODERN	M AA D ER N
SENIOR	S IY N Y ER
IRELAND	AY ER L AH N D
SEXY	S EH K S IY
TEACHING	T IY CH IH NG
DOOR	D AO R
GRAND	G R AE N D
TESTING	T EH S T IH NG
TRIAL	T R AY AH L
CHARGE	CH AA R JH
UNITS	Y UW N AH T S
INSTEAD	IH N S T EH D
CANADIAN	K AH N EY D IY AH N
COOL	K UW L
NORMAL	N AO R M AH L
WROTE	R OW T
ENTERPRISE	EH N T ER P R AY Z
SHIPS	SH IH P S
ENTIRE	IH N T AY ER
EDUCATIONAL	EH JH AH K EY SH AH N AH L
MD	EH M D
LEADING	L IY D IH NG
METAL	M EH T AH L
POSITIVE	P AA Z AH T IH V
FL	EH F L
FITNESS	F IH T N AH S
CHINESE	CH AY N IY Z
OPINION	AH P IH N Y AH N
MB	EH M B
ASIA	EY ZH AH
FOOTBALL	F UH T B AO L
ABSTRACT	AE B S T R AE K T
USES	Y UW S AH Z
OUTPUT	AW T P UH T
FUNDS	F AH N D Z
MR	M IH S T ER
GREATER	G R EY T ER
LIKELY	L AY K L IY
DEVELOP	D IH V EH L AH P
EMPLOYEES	EH M P L OY IY Z
ARTISTS	AA R T IH S T S
ALTERNATIVE	AO L T ER N AH T IH V
PROCESSING	P R AA S EH S IH NG
RESPONSIBILITY	R IY S P AA N S AH B IH L AH T IY
RESOLUTION	R EH Z AH L UW SH AH N
JAVA	JH AA V AH
GUEST	G EH S T
SEEMS	S IY M Z
PUBLICATION	P AH B L IH K EY SH AH N
PASS	P AE S
RELATIONS	R IY L EY SH AH N Z
TRUST	T R AH S T
VAN	V AE N
CONTAINS	K AH N T EY N Z
SESSION	S EH SH AH N
MULTI	M AH L T IY
PHOTOGRAPHY	F AH T AA G R AH F IY
REPUBLIC	R IY P AH B L AH K
FEES	F IY Z
COMPONENTS	K AH M P OW N AH N T S
VACATION	V EY K EY SH AH N
CENTURY	S EH N CH ER IY
ACADEMIC	AE K AH D EH M IH K
ASSISTANCE	AH S IH S T AH N S
COMPLETED	K AH M P L IY T AH D
SKIN	S K IH N
GRAPHICS	G R AE F IH K S
INDIAN	IH N D IY AH N
PREV	P R EH V
ADS	AE D Z
MARY	M EH R IY
IL	IH L
EXPECTED	IH K S P EH K T AH D
RING	R IH NG
GRADE	G R EY D
DATING	D EY T IH NG
PACIFIC	P AH S IH F IH K
MOUNTAIN	M AW N T AH N
ORGANIZATIONS	AO R G AH N AH Z EY SH AH N Z
POP	P AA P
FILTER	F IH L T ER
MAILING	M EY L IH NG
VEHICLE	V IY HH IH K AH L
LONGER	L AO NG G ER
CONSIDER	K AH N S IH D ER
INT	IH N T
NORTHERN	N AO R DH ER N
BEHIND	B IH HH AY N D
PANEL	P AE N AH L
FLOOR	F L AO R
GERMAN	JH ER M AH N
BUYING	B AY IH NG
MATCH	M AE CH
PROPOSED	P R AH P OW Z D
DEFAULT	D IH F AO L T
REQUIRE	R IY K W AY ER
IRAQ	IH R AA K
BOYS	B OY Z
OUTDOOR	AW T D AO R
DEEP	D IY P
MORNING	M AO R N IH NG
OTHERWISE	AH DH ER W AY Z
ALLOWS	AH L AW Z
REST	R EH S T
PROTEIN	P R OW T IY N
PLANT	P L AE N T
REPORTED	R IY P AO R T AH D
HIT	HH IH T
TRANSPORTATION	T R AE N S P ER T EY SH AH N
MM	EH M
POOL	P UW L
MINI	M IH N IY
POLITICS	P AA L AH T IH K S
PARTNER	P AA R T N ER
DISCLAIMER	D IH S K L EY M ER
AUTHORS	AO TH ER Z
BOARDS	B AO R D Z
FACULTY	F AE K AH L T IY
PARTIES	P AA R T IY Z
FISH	F IH SH
MEMBERSHIP	M EH M B ER SH IH P
MISSION	M IH SH AH N
EYE	AY
STRING	S T R IH NG
SENSE	S EH N S
MODIFIED	M AA D AH F AY D
PACK	P AE K
RELEASED	R IY L IY S T
STAGE	S T EY JH
INTERNAL	IH N T ER N AH L
GOODS	G UH D Z
RECOMMENDED	R EH K AH M EH N D AH D
BORN	B AO R N
UNLESS	AH N L EH S
RICHARD	R IH CH ER D
DETAILED	D IH T EY L D
JAPANESE	JH AE P AH N IY Z
RACE	R EY S
APPROVED	AH P R UW V D
BACKGROUND	B AE K G R AW N D
TARGET	T AA R G AH T
EXCEPT	IH K S EH P T
CHARACTER	K EH R IH K T ER
USB	AH Z
MAINTENANCE	M EY N T AH N AH N S
ABILITY	AH B IH L AH T IY
MAYBE	M EY B IY
FUNCTIONS	F AH NG K SH AH N Z
ED	EH D
MOVING	M UW V IH NG
BRANDS	B R AE N D Z
PLACES	P L EY S AH Z
PHP	P IY EY CH P
PRETTY	P R IH T IY
TRADEMARKS	T R EY D M AA R K S
PHENTERMINE	F EH N T AH R M AY N
SPAIN	S P EY N
SOUTHERN	S AH DH ER N
YOURSELF	Y ER S EH L F
ETC	EH T S EH T ER AH
WINTER	W IH N T ER
RAPE	R EY P
BATTERY	B AE T ER IY
YOUTH	Y UW TH
PRESSURE	P R EH SH ER
SUBMITTED	S AH B M IH T AH D
BOSTON	B AA S T AH N
INCEST	IH N S EH S T
DEBT	D EH T
KEYWORDS	K IY W ER D Z
MEDIUM	M IY D IY AH M
TELEVISION	T EH L AH V IH ZH AH N
INTERESTED	IH N T AH R EH S T IH D
CORE	K AO R
BREAK	B R EY K
PURPOSES	P ER P AH S AH Z
THROUGHOUT	TH R UW AW T
SETS	S EH T S
DANCE	D AE N S
WOOD	W UH D
MSN	EH M EH S N
ITSELF	IH T S EH L F
DEFINED	D IH F AY N D
PAPERS	P EY P ER Z
PLAYING	P L EY IH NG
AWARDS	AH W AO R D Z
FEE	F IY
STUDIO	S T UW D IY OW
READER	R IY D ER
VIRTUAL	V ER CH UW AH L
DEVICE	D IH V AY S
ESTABLISHED	IH S T AE B L IH SH T
ANSWERS	AE N S ER Z
RENT	R EH N T
LAS	L AA S
REMOTE	R IH M OW T
DARK	D AA R K
PROGRAMMING	P R OW G R AE M IH NG
EXTERNAL	IH K S T ER N AH L
APPLE	AE P AH L
LE	L AH
REGARDING	R AH G AA R D IH NG
INSTRUCTIONS	IH N S T R AH K SH AH N Z
MIN	M IH N
OFFERED	AO F ER D
THEORY	TH IH R IY
ENJOY	EH N JH OY
REMOVE	R IY M UW V
AID	EY D
SURFACE	S ER F AH S
MINIMUM	M IH N AH M AH M
VISUAL	V IH ZH AH W AH L
HOST	HH OW S T
VARIETY	V ER AY AH T IY
TEACHERS	T IY CH ER Z
ISBN	IH Z N
MARTIN	M AA R T AH N
MANUAL	M AE N Y UW AH L
BLOCK	B L AA K
SUBJECTS	S AH B JH IH K T S
AGENTS	EY JH AH N T S
INCREASED	IH N K R IY S T
REPAIR	R IH P EH R
FAIR	F EH R
CIVIL	S IH V AH L
STEEL	S T IY L
UNDERSTANDING	AH N D ER S T AE N D IH NG
SONGS	S AO NG Z
FIXED	F IH K S T
WRONG	R AO NG
BEGINNING	B IH G IH N IH NG
HANDS	HH AE N D Z
ASSOCIATES	AH S OW S IY AH T S
FINALLY	F AY N AH L IY
AZ	AE Z
UPDATES	AH P D EY T S
DESKTOP	D EH S K T AA P
CLASSES	K L AE S AH Z
PARIS	P EH R IH S
OHIO	OW HH AY OW
GETS	G EH T S
SECTOR	S EH K T ER
CAPACITY	K AH P AE S AH T IY
REQUIRES	R IY K W AY ER Z
JERSEY	JH ER Z IY
UN	AH N
FAT	F AE T
FULLY	F UH L IY
FATHER	F AA DH ER
ELECTRIC	IH L EH K T R IH K
SAW	S AO
INSTRUMENTS	IH N S T R AH M AH N T S
QUOTES	K W OW T S
OFFICER	AO F AH S ER
DRIVER	D R AY V ER
BUSINESSES	B IH Z N AH S AH Z
DEAD	D EH D
RESPECT	R IH S P EH K T
UNKNOWN	AH N N OW N
SPECIFIED	S P EH S AH F AY D
RESTAURANT	R EH S T ER AA N T
MIKE	M AY K
TRIP	T R IH P
PST	P IY EH S T
WORTH	W ER TH
MI	M IY
PROCEDURES	P R AH S IY JH ER Z
POOR	P UW R
TEACHER	T IY CH ER
XXX	EH K S EH K S Z
EYES	AY Z
RELATIONSHIP	R IY L EY SH AH N SH IH P
WORKERS	W ER K ER Z
FARM	F AA R M
FUCKING	F AH K IH NG
GEORGIA	JH AO R JH AH
PEACE	P IY S
TRADITIONAL	T R AH D IH SH AH N AH L
CAMPUS	K AE M P AH S
TOM	T AA M
SHOWING	SH OW IH NG
CREATIVE	K R IY EY T IH V
COAST	K OW S T
BENEFIT	B EH N AH F IH T
PROGRESS	P R AA G R EH S
FUNDING	F AH N D IH NG
DEVICES	D IH V AY S AH Z
LORD	L AO R D
GRANT	G R AE N T
SUB	S AH B
AGREE	AH G R IY
FICTION	F IH K SH AH N
HEAR	HH IY R
SOMETIMES	S AH M T AY M Z
WATCHES	W AA CH AH Z
CAREERS	K ER IH R Z
BEYOND	B IH AA N D
GOES	G OW Z
FAMILIES	F AE M AH L IY Z
LED	L EH D
MUSEUM	M Y UW Z IY AH M
THEMSELVES	DH EH M S EH L V Z
FAN	F AE N
TRANSPORT	T R AE N S P AO R T
INTERESTING	IH N T AH R EH S T IH NG
BLOGS	B L AO G Z
WIFE	W AY F
EVALUATION	IH V AE L Y UW EY SH AH N
ACCEPTED	AE K S EH P T IH D
FORMER	F AO R M ER
IMPLEMENTATION	IH M P L AH M EH N T EY SH AH N
TEN	T EH N
HITS	HH IH T S
ZONE	Z OW N
COMPLEX	K AA M P L EH K S
TH	T IY EY CH
CAT	K AE T
GALLERIES	G AE L ER IY Z
REFERENCES	R EH F ER AH N S IH Z
DIE	D AY
PRESENTED	P R IY Z EH N T AH D
JACK	JH AE K
FLAT	F L AE T
FLOW	F L OW
AGENCIES	EY JH AH N S IY Z
LITERATURE	L IH T ER AH CH ER
RESPECTIVE	R IH S P EH K T IH V
PARENT	P EH R AH N T
SPANISH	S P AE N IH SH
MICHIGAN	M IH SH IH G AH N
COLUMBIA	K AH L AH M B IY AH
SETTING	S EH T IH NG
DR	D R AY V
SCALE	S K EY L
STAND	S T AE N D
ECONOMY	IH K AA N AH M IY
HIGHEST	HH AY AH S T
HELPFUL	HH EH L P F AH L
MONTHLY	M AH N TH L IY
CRITICAL	K R IH T IH K AH L
FRAME	F R EY M
MUSICAL	M Y UW Z IH K AH L
DEFINITION	D EH F AH N IH SH AH N
SECRETARY	S EH K R AH T EH R IY
ANGELES	AE N JH AH L IH S
NETWORKING	N EH T W ER K IH NG
PATH	P AE TH
AUSTRALIAN	AO S T R EY L Y AH N
EMPLOYEE	EH M P L OY IY
CHIEF	CH IY F
GIVES	G IH V Z
KB	K EY B
BOTTOM	B AA T AH M
MAGAZINES	M AE G AH Z IY N Z
PACKAGES	P AE K AH JH AH Z
DETAIL	D IH T EY L
FRANCISCO	F R AE N S IH S K OW
LAWS	L AO Z
CHANGED	CH EY N JH D
PET	P EH T
HEARD	HH ER D
BEGIN	B IH G IH N
INDIVIDUALS	IH N D AH V IH JH AH W AH L Z
COLORADO	K AA L ER AA D OW
ROYAL	R OY AH L
CLEAN	K L IY N
SWITCH	S W IH CH
RUSSIAN	R AH SH AH N
LARGEST	L AA R JH AH S T
AFRICAN	AE F R IH K AA N
GUY	G AY
TITLES	T AY T AH L Z
RELEVANT	R EH L AH V AH N T
GUIDELINES	G AY D L AY N Z
JUSTICE	JH AH S T AH S
CONNECT	K AH N EH K T
BIBLE	B AY B AH L
DEV	D EH V
CUP	K AH P
BASKET	B AE S K AH T
APPLIED	AH P L AY D
WEEKLY	W IY K L IY
VOL	V AA L
INSTALLATION	IH N S T AH L EY SH AH N
DESCRIBED	D IH S K R AY B D
DEMAND	D IH M AE N D
PP	P IY P
SUITE	S W IY T
VEGAS	V EY G AH S
NA	N AA
SQUARE	S K W EH R
CHRIS	K R IH S
ATTENTION	AH T EH N SH AH N
ADVANCE	AH D V AE N S
SKIP	S K IH P
DIET	D AY AH T
ARMY	AA R M IY
AUCTION	AA K SH AH N
GEAR	G IH R
LEE	L IY
OS	AA S
DIFFERENCE	D IH F ER AH N S
ALLOWED	AH L AW D
CORRECT	K ER EH K T
CHARLES	CH AA R L Z
NATION	N EY SH AH N
SELLING	S EH L IH NG
LOTS	L AA T S
PIECE	P IY S
SHEET	SH IY T
FIRM	F ER M
SEVEN	S EH V AH N
OLDER	OW L D ER
ILLINOIS	IH L AH N OY
REGULATIONS	R EH G Y AH L EY SH AH N Z
ELEMENTS	EH L AH M AH N T S
SPECIES	S P IY SH IY Z
JUMP	JH AH M P
CELLS	S EH L Z
MODULE	M AA JH UW L
RESORT	R IH Z AO R T
FACILITY	F AH S IH L IH T IY
RANDOM	R AE N D AH M
PRICING	P R AY S IH NG
DVDS	D IY V IY D IY Z
CERTIFICATE	S ER T IH F IH K AH T
MINISTER	M IH N AH S T ER
MOTION	M OW SH AH N
LOOKS	L UH K S
FASHION	F AE SH AH N
DIRECTIONS	D ER EH K SH AH N Z
VISITORS	V IH Z IH T ER Z
DOCUMENTATION	D AA K Y AH M EH N T EY SH AH N
MONITOR	M AA N AH T ER
TRADING	T R EY D IH NG
FOREST	F AO R AH S T
CALLS	K AO L Z
WHOSE	HH UW Z
COVERAGE	K AH V ER AH JH
COUPLE	K AH P AH L
GIVING	G IH V IH NG
CHANCE	CH AE N S
VISION	V IH ZH AH N
BALL	B AO L
ENDING	EH N D IH NG
CLIENTS	K L AY AH N T S
ACTIONS	AE K SH AH N Z
LISTEN	L IH S AH N
DISCUSS	D IH S K AH S
ACCEPT	AE K S EH P T
AUTOMOTIVE	AO T AH M OW T IH V
NAKED	N EY K AH D
GOAL	G OW L
SUCCESSFUL	S AH K S EH S F AH L
SOLD	S OW L D
WIND	W AY N D
COMMUNITIES	K AH M Y UW N AH T IY Z
CLINICAL	K L IH N AH K AH L
SITUATION	S IH CH UW EY SH AH N
SCIENCES	S AY AH N S AH Z
MARKETS	M AA R K AH T S
LOWEST	L OW AH S T
HIGHLY	HH AY L IY
PUBLISHING	P AH B L IH SH IH NG
APPEAR	AH P IH R
EMERGENCY	IH M ER JH AH N S IY
DEVELOPING	D IH V EH L AH P IH NG
LIVES	L IH V Z
CURRENCY	K ER AH N S IY
LEATHER	L EH DH ER
DETERMINE	D AH T ER M AH N
MILF	M IH L F
TEMPERATURE	T EH M P R AH CH ER
PALM	P AA M
ANNOUNCEMENTS	AH N AW N S M EH N T S
PATIENT	P EY SH AH N T
ACTUAL	AE K CH AH W AH L
HISTORICAL	HH IH S T AO R IH K AH L
STONE	S T OW N
BOB	B AA B
COMMERCE	K AA M ER S
RINGTONES	R IH NG T OW N Z
PERHAPS	P ER HH AE P S
PERSONS	P ER S AH N Z
DIFFICULT	D IH F AH K AH L T
SCIENTIFIC	S AY AH N T IH F IH K
SATELLITE	S AE T AH L AY T
FIT	F IH T
TESTS	T EH S T S
VILLAGE	V IH L AH JH
ACCOUNTS	AH K AW N T S
AMATEUR	AE M AH CH ER
EX	EH K S
MET	M EH T
PAIN	P EY N
XBOX	Z B AA K S
PARTICULARLY	P AA R T IH K Y AH L ER L IY
FACTORS	F AE K T ER Z
COFFEE	K AA F IY
WWW	D AH B AH L Y UW D AH B AH L Y UW W
SETTINGS	S EH T IH NG Z
CUM	K AH M
BUYER	B AY ER
CULTURAL	K AH L CH ER AH L
STEVE	S T IY V
EASILY	IY Z AH L IY
ORAL	AO R AH L
FORD	F AO R D
POSTER	P OW S T ER
EDGE	EH JH
FUNCTIONAL	F AH NG K SH AH N AH L
ROOT	R UW T
AU	OW
FI	F AY
CLOSED	K L OW Z D
HOLIDAYS	HH AA L AH D EY Z
ICE	AY S
PINK	P IH NG K
ZEALAND	Z IY L AH N D
BALANCE	B AE L AH N S
MONITORING	M AA N AH T ER IH NG
GRADUATE	G R AE JH AH W AH T
REPLIES	R IH P L AY Z
SHOT	SH AA T
NC	EH N K
ARCHITECTURE	AA R K AH T EH K CH ER
INITIAL	IH N IH SH AH L
LABEL	L EY B AH L
THINKING	TH IH NG K IH NG
SCOTT	S K AA T
SEC	S EH K
RECOMMEND	R EH K AH M EH N D
CANON	K AE N AH N
HARDCORE	HH AA R D K AO R
LEAGUE	L IY G
WASTE	W EY S T
MINUTE	M IH N AH T
BUS	B AH S
PROVIDER	P R AH V AY D ER
OPTIONAL	AA P SH AH N AH L
DICTIONARY	D IH K SH AH N EH R IY
COLD	K OW L D
ACCOUNTING	AH K AW N T IH NG
MANUFACTURING	M AE N Y AH F AE K CH ER IH NG
SECTIONS	S EH K SH AH N Z
CHAIR	CH EH R
FISHING	F IH SH IH NG
EFFORT	EH F ER T
PHASE	F EY Z
FIELDS	F IY L D Z
BAG	B AE G
FANTASY	F AE N T AH S IY
PO	P OW
LETTERS	L EH T ER Z
MOTOR	M OW T ER
VA	V AA
PROFESSOR	P R AH F EH S ER
